########################################################################################
|                                          |                                           |
|                                                                                      |
|                                                                                      |
|                                          |                                           |
###  ###############  ######################                                           |
|                  |  |                    |                                           |
|                  |  |                    |                                           |
|                                          |                                           |
|                  |  |                    |                                           |
|                  |  |                    |                                           |
|                  |  |                    |                                           |
|                  |  |                    |                                           |
|                  |  |                    |                                           |
|                  |  |                    |                                           |
|                  |  |                    |                                           |
|                  |  |                    |                                           |
|                  |  |                    |                                           |
|                                          |                                           |
|                  |  |                    |                                           |
|                  |  |                    |                                           |
####################  ######################                                           |
|                                          |                                           |
|                                          |                                           |
|                                          |                                           |
|                                          |                                           |
|                                          |                                           |
|                                          |                                           |
|                                          |                                           |
|                                          |                                           |
|                                          |                                           |
|                                          |                                           |
|                                          |                                           |
|                                          |                                           |
|                                          |                                           |
|                                          |                                           |
|                                          |                                           |
|                                          |                                           |
|                                                                                      |
|                                                                                      |
|                                          |                                           |
|                                          |                                           |
|                                          |                                           |
########################################################################################
