############################################
|                                          |
|                                          |
|                                          |
|                                          |
###  ##################  ###################
|                   |                      |
|                   |                      |
|                   |                      |
|                   |                      |
|                   |                      |
|                   |                      |
|                   |                      |
|                   |                      |
|                   |                      |
|                   |                      |
|                                          |
|                   |                      |
|                   |                      |
|                   |                      |
|                   |                      |
###  #######################################
|                                          |
|                                          |
|                                          |
|                                          |
|                                          |
|                                          |
|                                          |
############################################
