#########
|       |
|       |
|       |
|       |
###  ################
|                   |
|                   |
|                   |
|                   |
|                   |
#####################
