---------
|       |
|       |
|       |
|       |
---  ----------------
|                   |
|             x     |
|                   |
|                   |
|                   |
---------------------
