########################################################################################
|                                          |                                           |
|                                                                                      |
|                                          |                                           |
|                                          |                                           |
###  ##################  ###################                                           |
|                   |                      |                                           |
|                   |                      |                                           |
|                   |                      |                                           |
|                   |                      |                                           |
|                   |                      |                                           |
|                   |                      |                                           |
|                   |                      |                                           |
|                   |                      |                                           |
|                   |                      |                                           |
|                   |                      |                                           |
|                                                                                      |
|                   |                      |                                           |
|                   |                      |                                           |
|                   |                      |                                           |
|                   |                      |                                           |
###  #######################################                                           |
|                                          |                                           |
|                                          |                                           |
|                                          |                                           |
|                                          |                                           |
|                                          |                                           |
|                                          |                                           |
|                                          |                                           |
|                                          |                                           |
|                                          |                                           |
|                                          |                                           |
|                                          |                                           |
|                                          |                                           |
|                                          |                                           |
|                                          |                                           |
|                                          |                                           |
|                                          |                                           |
|                                          |                                           |
|                                          |                                           |
|                                          |                                           |
|                                          |                                           |
|                                          |                                           |
########################################################################################
